############################
#@           ##            #
# #### ##### ## #### ##### #
# #### ##### ## #### ##### #
# #### ##### ## #### ##### #
#                          #
# #### ## ######## ## #### #
# #### ## ######## ## #### #
#      ##    ##    ##      #
###### ##### ## ##### ######
###### ##### ## ##### ######      
###### ##   $      ## ######
###### ## ######## ## ######
######    ########    ######
###### ## ######## ## ######
###### ##  &       ## ######
###### ## ######## ## ######
###### ## ######## ## ######
#            ##            #
# #### ##### ## ##### #### #
# #### ##### ## ##### #### #
#   ##                ##   #
### ## ## ######## ## ## ### 
### ## ## ######## ## ## ###
#      ##    ##    ##      #
# ########## ## ########## #
# ########## ## ########## #
#                          #
############################